{"grid":[
1,1,1,1,1,1,1,0,0,0,9,0,0,1,1,1,1,1,1,1,
1,1,1,1,1,1,1,0,0,0,0,0,0,1,1,1,1,1,1,1,
1,1,1,1,1,1,1,0,0,0,0,0,0,1,1,1,1,1,1,1,
1,1,1,0,0,0,0,0,0,0,0,0,0,0,0,0,0,1,1,1,
1,1,1,0,0,0,0,1,1,1,1,1,1,0,0,0,0,1,1,1,
1,1,1,0,0,0,0,1,1,1,1,1,1,0,0,0,0,1,1,1,
1,1,1,0,0,0,0,3,1,1,1,1,2,0,0,0,0,1,1,1,
1,1,1,0,0,0,0,1,1,1,1,1,1,0,0,0,0,1,1,1,
1,1,1,0,0,0,0,1,1,1,1,1,1,0,0,0,0,1,1,1,
1,1,1,0,0,0,0,0,0,1,1,0,0,0,0,0,0,1,1,1,
1,1,1,1,1,1,1,0,0,0,0,0,0,1,1,1,1,1,1,1,
1,1,1,1,1,1,1,0,0,0,8,0,0,1,1,1,1,1,1,1
],
"playerDirection": "down",
"laserCadences":[2,3],
"laserOffsets": [1,2]
}