{"grid":[
1,1,1,1,1,1,1,1,1,1,9,1,1,1,1,1,1,1,1,1,
1,1,1,1,1,1,1,1,1,1,0,1,1,1,1,1,1,1,1,1,
1,1,1,1,1,1,1,1,1,1,0,1,1,1,1,1,1,1,1,1,
1,1,1,0,0,0,0,0,0,0,0,0,0,0,0,0,0,1,1,1,
1,1,1,0,0,0,0,0,0,0,1,1,1,1,1,2,0,1,1,1,
1,1,1,0,0,0,0,0,0,0,1,1,1,1,1,1,0,1,1,1,
1,1,1,0,0,0,0,0,0,0,3,1,1,1,1,2,0,1,1,1,
1,1,1,0,0,0,0,0,0,0,1,1,1,1,1,1,0,1,1,1,
1,1,1,0,0,0,0,0,0,0,1,1,1,1,1,2,0,1,1,1,
1,1,1,8,0,0,0,0,0,0,0,0,0,0,0,0,0,1,1,1,
1,1,1,1,1,1,1,1,1,1,1,1,1,1,1,1,1,1,1,1,
1,1,1,1,1,1,1,1,1,1,1,1,1,1,1,1,1,1,1,1
],
"playerDirection": 1,
"laserCadences":[2,2,2,2],
"laserOffsets": [1,1,1,1],
"starTargets":[29,28]
}