{"grid":[
8,1,1,1,1,1,1,1,1,1,1,1,1,1,1,1,1,1,1,1,
0,1,1,1,1,1,1,1,1,1,1,1,1,1,1,1,1,1,1,1,
0,0,0,0,0,0,0,10,1,1,1,1,1,1,1,1,1,1,1,1,
1,1,1,1,1,0,0,1,1,1,1,1,1,1,1,1,1,1,1,1,
1,1,1,1,1,0,0,1,1,1,1,1,1,1,1,1,1,1,1,1,
1,1,1,1,1,0,0,1,1,1,1,1,1,1,1,1,1,1,1,1,
1,1,1,1,1,6,9,0,0,0,0,0,0,0,0,0,0,0,0,0,
1,1,1,1,1,0,7,1,1,1,1,1,1,1,1,1,1,1,0,0,
1,1,1,1,1,0,0,1,1,1,1,1,1,1,1,1,1,1,0,0,
1,1,1,1,1,0,0,1,1,1,1,1,1,1,1,1,1,1,0,0,
1,1,1,1,1,0,0,1,1,1,1,1,1,1,1,1,1,1,0,0,
2,0,0,0,0,0,0,0,0,0,0,0,0,0,0,0,0,0,0,0
],
"playerDirection": 1,
"laserCadences":[22],
"mouseDelays":[3],
"starTargets":[112,84],
"movesPosition":[13,11]
}