{"grid":[
0,9,0,0,0,0,0,0,0,7,0,0,0,0,0,0,0,0,0,0,
0,1,1,1,1,1,1,1,1,1,1,1,1,1,1,1,1,1,1,0,
0,0,0,0,0,0,0,0,0,0,7,0,0,0,0,0,0,0,1,0,
0,0,1,1,1,1,1,1,1,1,1,1,1,1,1,1,1,0,1,0,
0,0,1,1,0,0,1,0,0,0,0,0,0,0,0,6,1,0,1,0,
0,0,1,1,0,0,1,0,0,0,0,0,0,0,0,1,1,0,1,0,
0,7,1,1,0,0,1,0,0,0,0,0,0,0,0,0,0,7,1,7,
0,0,1,1,0,0,0,0,0,0,0,0,0,0,0,0,0,0,1,0,
0,0,1,1,0,0,0,0,0,0,0,0,0,0,0,0,0,0,1,0,
0,0,8,1,0,0,0,0,0,0,0,0,0,0,0,0,0,0,1,0,
0,0,1,1,1,1,1,1,1,1,1,1,1,1,1,1,1,1,1,0,
1,0,0,0,0,0,0,0,0,7,0,0,0,0,0,0,0,0,0,0],
"playerDirection": 2,
"mouseDelays":[4,6,8,10,12,14],
"starTargets":[248,238],
"movesPosition":[3,4]
}
