{"grid":[
1,1,1,1,1,1,0,0,0,0,0,0,0,0,0,0,0,0,0,0,
9,0,0,0,0,1,0,0,0,0,0,0,0,0,0,0,0,0,0,0,
0,0,0,0,0,1,0,1,1,1,1,1,1,1,1,1,1,1,1,0,
0,1,1,1,0,0,0,1,1,1,1,1,1,1,1,6,0,0,0,0,
0,1,1,1,0,0,0,1,1,1,1,1,1,1,1,0,0,0,0,0,
0,1,1,1,1,1,1,1,1,1,1,1,1,1,1,0,0,0,0,0,
0,0,0,0,0,1,1,1,1,8,0,0,0,0,0,0,0,0,0,0,
1,1,1,1,0,1,1,1,1,1,1,1,1,1,1,0,1,1,1,1,
1,1,1,1,0,1,1,1,1,1,1,1,1,1,1,0,1,1,1,1,
1,1,1,1,6,1,1,1,1,1,1,1,1,1,1,6,1,1,1,1,
1,1,1,1,1,1,1,1,1,1,1,1,1,1,1,1,1,1,1,1,
1,1,1,1,1,1,1,1,1,1,1,1,1,1,1,1,1,1,1,1],
"playerDirection": 2,
"starTargets":[74,62]
}
