{"grid":[
0,0,0,0,0,0,0,0,0,0,0,0,0,0,0,0,0,1,1,1,
0,0,0,0,0,0,0,0,0,0,0,0,0,0,0,0,0,0,0,0,
0,0,0,0,0,0,0,0,0,0,0,0,0,0,0,0,0,0,0,0,
0,0,0,1,1,1,1,1,1,1,1,1,1,1,1,0,1,0,0,0,
0,0,0,1,1,1,1,1,1,1,1,1,1,1,1,0,1,0,0,0,
0,0,0,1,1,1,1,1,1,8,0,0,0,0,0,0,1,0,0,0,
0,0,0,1,1,1,1,1,1,1,1,1,1,1,1,1,1,0,0,0,
0,0,0,1,1,1,1,1,1,1,1,1,1,1,1,1,1,0,0,0,
6,6,6,0,0,0,0,0,0,0,0,0,0,0,0,0,0,0,0,0,
6,9,6,0,0,0,0,0,0,0,0,0,0,0,0,0,7,7,7,0,
6,6,6,0,0,0,0,0,0,0,0,0,0,0,0,0,0,0,0,0,
1,1,1,0,0,0,0,0,0,0,0,0,0,0,0,0,0,0,0,0],
"playerDirection": 2,
"mouseDelays":[40,39,38],
"starTargets":[202,188]
}
