{"grid":[
1,1,1,1,1,1,1,1,1,1,1,1,1,1,1,1,1,1,1,1,
1,1,1,1,1,1,1,1,1,1,1,1,1,1,1,1,1,1,1,1,
1,1,0,0,0,0,0,0,0,0,0,0,7,7,7,7,7,7,9,0,
1,1,0,0,0,0,0,0,0,0,0,0,0,0,0,0,0,3,1,0,
1,1,0,0,1,1,1,1,1,0,1,1,1,1,1,1,0,1,1,0,
1,1,2,0,0,0,0,0,0,0,1,1,1,1,1,1,0,1,1,0,
1,1,0,0,0,0,0,0,0,0,1,1,1,1,1,1,0,1,1,0,
1,1,0,0,1,1,1,1,1,0,1,1,1,1,1,1,0,1,1,0,
1,1,0,0,1,1,1,1,1,0,1,1,1,1,1,1,0,1,1,0,
1,1,0,0,0,0,0,0,0,0,0,0,0,0,0,0,0,1,1,0,
1,1,1,1,1,1,1,1,1,1,1,1,1,1,1,1,1,1,1,0,
1,1,1,1,1,1,1,1,1,1,1,1,1,1,1,1,1,1,1,8],
"playerDirection": -2,
"laserCadences":[4,3],
"laserOffsets": [1,3],
"mouseDelays":[2,3,4,5,6,8],
"starTargets":[90,64],
"movesPosition":[13,7]
}