{"grid":[
9,0,0,0,0,0,0,0,0,0,0,0,0,0,0,0,0,0,1,8,
0,0,0,1,1,1,1,1,1,1,1,1,1,1,1,1,1,0,1,6,
0,0,0,1,1,1,1,1,1,1,1,1,1,1,1,1,1,0,1,0,
0,0,0,1,1,1,1,1,1,1,1,1,1,1,1,1,1,0,1,0,
0,0,0,1,1,1,1,1,1,1,1,1,1,1,1,1,1,0,1,0,
0,0,0,1,1,1,1,1,1,1,1,1,1,1,1,1,1,0,1,0,
0,0,0,1,1,1,1,1,1,1,1,1,1,1,1,1,1,0,1,0,
0,0,0,1,1,1,1,1,1,1,1,1,1,1,1,1,1,0,1,0,
0,0,0,1,1,1,1,1,1,1,1,1,1,1,1,1,1,0,1,0,
0,0,0,1,1,1,1,1,1,1,1,1,1,1,1,1,1,0,1,0,
0,0,0,1,1,1,1,1,1,1,1,1,1,1,1,1,1,0,1,0,
0,0,0,0,0,0,0,0,0,7,0,0,0,0,0,0,0,0,0,0],
"playerDirection": 2,
"laserCadences":[2],
"laserOffsets": [1, 1],
"mouseDelays":[20],
"starTargets":[135,133],
"movesPosition":[4,11]
}
