{"grid":[
9,0,0,0,0,0,0,0,0,0,0,1,1,1,1,1,0,0,0,8,
0,0,0,0,0,0,0,0,0,0,0,0,0,0,0,0,0,3,1,1,
0,0,0,0,0,0,0,0,0,0,0,0,0,0,0,0,0,1,1,1,
0,0,0,0,0,0,0,0,0,0,0,0,0,0,0,0,0,1,1,1,
0,0,0,0,0,0,0,0,0,0,0,0,0,0,0,0,1,1,1,1,
0,0,0,0,0,0,0,0,0,0,0,0,0,0,0,1,1,1,1,1,
0,0,0,0,0,0,0,0,0,0,0,0,0,0,1,1,1,1,1,1,
0,0,0,0,0,0,0,0,0,0,0,0,0,1,1,1,1,1,1,1,
0,0,0,0,0,0,0,0,0,0,0,0,1,1,1,1,1,1,1,1,
0,0,0,0,0,0,0,0,0,0,0,1,1,1,1,1,1,1,1,1,
0,1,1,1,1,1,1,1,1,1,1,1,1,1,1,1,1,1,1,1,
0,0,0,0,0,0,0,0,0,0,6,6,6,6,6,6,1,1,1,1],
"playerDirection": 2,
"laserCadences":[],
"laserOffsets": [],
"mouseDelays":[],
"starTargets":[1,1]
}
