{"grid":[
9,0,0,0,0,0,1,1,1,1,1,1,1,8,0,0,0,0,0,1,
0,1,1,1,1,0,1,1,1,1,1,1,1,1,1,1,1,1,0,1,
0,1,1,1,1,0,1,1,1,1,1,1,0,0,0,0,0,0,0,0,
0,1,1,1,1,0,1,1,1,1,1,1,1,1,1,1,1,0,1,1,
0,1,1,1,1,0,1,1,1,1,1,1,0,0,0,0,0,0,0,0,
0,1,1,1,1,0,1,1,1,1,1,1,10,1,1,1,0,1,1,1,
0,1,1,1,1,0,1,1,1,1,1,1,1,1,1,1,0,0,0,0,
0,0,0,0,0,0,1,1,1,1,1,1,1,1,1,1,0,0,0,0,
0,1,1,1,1,1,1,1,1,1,1,1,6,6,6,6,0,0,0,0,
0,1,1,1,1,1,1,1,1,1,1,1,1,1,1,1,0,0,0,0,
0,1,1,1,1,1,1,1,1,1,1,1,1,1,1,1,0,0,1,1,
0,0,0,0,0,0,0,0,0,0,0,0,0,0,0,0,0,0,1,1],
"playerDirection": 2,
"laserCadences":[],
"laserOffsets": [],
"mouseDelays":[],
"starTargets":[145,139],
"movesPosition":[19,11]
}
