{"grid":[
0,0,0,0,0,0,1,0,0,0,0,0,0,0,0,0,0,0,0,0,
0,1,1,5,0,0,1,0,0,0,0,0,0,0,0,0,0,0,0,0,
0,0,0,0,8,0,0,0,1,1,1,1,1,1,1,1,1,1,1,0,
0,1,1,0,0,0,1,0,1,1,1,1,1,1,1,1,1,1,1,0,
0,1,0,0,1,0,1,4,1,1,1,1,1,1,1,1,1,1,1,0,
0,1,0,0,0,0,1,0,0,0,0,0,0,0,0,0,0,0,0,0,
0,1,6,1,1,1,1,1,0,1,1,1,1,1,1,1,1,1,1,0,
0,1,9,1,1,1,1,0,0,0,0,0,0,0,0,0,0,0,0,0,
0,1,1,1,0,0,0,0,0,1,1,1,1,1,1,1,1,1,1,0,
0,0,0,0,0,0,1,0,0,1,1,1,1,1,1,1,1,1,1,0,
0,1,1,1,0,0,0,0,0,0,0,0,0,0,0,0,0,0,0,0,
4,1,1,1,1,1,1,1,1,1,1,1,1,1,1,1,1,1,1,4],
"playerDirection": -1,
"starTargets":[91,92]
}
