{"grid":[
6,6,9,0,0,0,0,0,0,1,0,0,0,0,0,0,0,1,1,1,
0,1,1,0,1,1,1,1,0,1,0,1,1,1,1,1,0,1,1,1,
0,0,0,0,1,1,1,1,0,1,0,1,1,1,1,1,0,1,1,1,
0,1,1,1,1,1,1,1,0,1,0,1,1,1,1,1,0,1,1,1,
0,1,1,1,1,1,1,1,0,1,0,1,1,1,1,1,0,1,1,1,
0,1,1,1,1,0,0,0,0,1,0,1,1,1,1,1,0,1,1,1,
0,1,1,1,1,0,1,1,1,1,0,1,1,1,1,1,0,0,0,0,
0,0,0,0,0,0,0,0,0,0,0,0,0,0,0,0,0,1,1,0,
0,0,0,1,1,1,1,1,1,1,0,1,1,1,1,1,1,1,1,0,
0,0,0,0,0,0,0,0,0,8,0,1,1,1,1,1,1,1,1,0,
0,0,0,0,0,0,0,0,0,0,0,1,1,1,1,1,1,1,1,0,
0,0,0,0,0,0,0,0,0,0,0,0,0,0,0,0,0,0,0,0],
"playerDirection": 2,
"laserCadences":[],
"laserOffsets": [],
"mouseDelays":[],
"starTargets":[148,120]
}
