{"grid":[
6,0,0,0,0,0,0,1,1,1,1,1,1,1,1,1,1,1,1,1,
10,1,1,1,1,1,0,1,1,1,1,1,0,0,0,0,0,0,0,1,
1,1,1,1,1,1,0,0,0,0,0,1,0,1,1,1,1,1,0,1,
1,1,1,1,1,1,1,1,1,1,0,0,0,1,1,1,1,1,0,0,
1,1,1,1,1,1,1,1,1,1,1,1,1,1,1,1,1,1,0,1,
1,1,1,1,1,1,1,9,0,0,0,0,0,0,1,1,1,1,0,0,
1,1,1,1,1,1,1,0,0,0,0,0,0,0,1,1,1,1,0,0,
0,0,0,0,0,0,1,0,0,0,1,0,0,0,1,1,1,0,0,0,
1,1,0,1,1,1,1,1,1,0,1,1,1,1,1,1,1,0,0,0,
2,0,0,0,0,0,0,0,0,0,0,0,0,0,0,0,0,0,0,1,
1,1,1,1,0,1,0,1,0,1,0,1,0,1,1,1,1,1,0,1,
1,1,1,1,0,1,0,1,0,1,0,1,0,1,1,1,1,1,0,8],
"playerDirection": 2,
"laserCadences":[10000],
"starTargets":[177,174],
"movesPosition":[1,7]
}
