{"grid":[
1,9,0,0,0,0,0,0,0,0,0,0,0,0,0,0,0,0,0,0,
1,0,0,1,1,1,1,1,1,1,1,1,0,0,1,0,0,0,0,0,
1,0,0,1,6,0,0,1,1,1,1,1,7,0,0,0,0,0,0,0,
1,0,0,1,1,1,0,1,1,1,1,0,0,0,0,1,0,0,0,0,
0,0,0,1,1,1,0,1,1,1,1,0,1,0,0,0,0,0,0,0,
0,0,0,0,0,0,0,1,1,1,1,0,0,0,0,0,0,0,0,0,
1,1,1,1,1,1,1,1,1,1,1,1,1,1,1,1,1,1,1,0,
1,1,1,1,1,1,1,8,1,1,1,0,0,0,0,0,0,0,0,0,
0,0,0,0,0,0,0,0,1,1,1,0,0,0,0,0,0,0,0,0,
0,0,1,1,1,1,1,1,1,1,1,0,0,0,1,0,0,0,0,0,
0,0,0,0,0,1,1,1,1,1,1,0,0,0,1,1,1,1,1,4,
1,1,1,0,0,0,0,0,0,0,0,0,0,0,3,1,1,1,1,1],
"playerDirection": 1,
"laserOffsets": [0,1],
"mouseDelays":[6],
"starTargets":[181,163]
}
