{"grid":[
2,0,0,0,0,0,0,0,0,0,0,0,0,0,0,0,0,0,0,0,
1,1,8,0,0,0,0,0,0,0,9,0,0,0,7,0,0,0,0,0,
1,1,1,1,1,1,1,1,1,1,1,1,1,1,1,1,1,1,0,0,
0,0,0,0,0,0,0,0,0,1,0,0,0,0,0,0,0,1,0,0,
0,1,0,0,0,0,0,0,0,0,0,0,0,0,0,0,0,1,0,0,
0,1,0,0,0,0,0,0,1,6,1,0,0,1,0,0,0,1,0,0,
0,1,0,0,0,0,0,0,1,1,1,0,0,0,0,0,0,1,0,0,
0,1,0,0,0,0,0,0,0,0,0,0,0,0,0,0,0,1,0,0,
0,1,0,0,0,0,0,0,0,0,0,0,0,0,0,0,0,1,0,0,
0,1,0,0,0,0,0,0,0,0,0,0,0,0,0,0,0,3,0,0,
0,1,1,1,1,1,1,1,1,1,1,1,1,4,1,1,1,1,0,0,
0,0,0,0,0,0,0,0,0,0,0,0,0,0,0,0,0,0,0,0],
"playerDirection": 2,
"laserCadences":[],
"laserOffsets": [1,0,1],
"mouseDelays":[3],
"starTargets":[278,268],
"movesPosition":[2,3]
}
