{"grid":[
1,1,1,1,1,1,1,1,1,1,9,1,1,1,0,0,0,0,0,0,
1,1,1,1,1,1,1,1,1,1,0,1,1,1,0,0,0,0,0,0,
0,0,0,0,0,0,0,0,0,0,0,0,0,0,0,1,1,1,1,0,
7,1,1,1,1,1,1,1,1,1,1,1,1,1,7,1,1,1,1,0,
0,1,1,1,1,1,1,1,1,1,1,1,1,1,0,1,1,1,1,0,
0,1,1,1,1,1,1,1,1,1,1,1,1,0,0,1,1,1,8,0,
0,0,0,0,0,0,1,1,1,1,1,1,1,0,1,1,1,1,1,0,
1,1,1,1,1,0,1,1,1,1,1,1,1,0,0,1,1,1,1,1,
0,0,0,0,0,0,1,1,1,1,1,1,1,1,0,1,0,0,0,0,
0,1,1,1,1,0,1,1,1,1,1,1,1,1,0,1,0,6,1,0,
0,1,1,1,1,0,1,1,1,1,1,1,1,1,0,1,1,1,1,0,
0,0,0,0,0,0,0,0,0,0,0,0,0,0,0,0,0,0,0,0],
"playerDirection": 1,
"mouseDelays":[7,5],
"starTargets":[101,97]
}
