{"grid":[
9,0,0,1,0,0,0,0,0,0,0,0,0,0,1,1,1,1,1,1,
1,0,0,1,0,0,0,0,0,0,0,0,0,0,1,1,1,1,1,1,
1,0,0,1,0,0,0,0,0,0,0,0,0,0,1,1,1,1,1,1,
1,0,0,1,0,1,1,1,1,1,1,0,0,0,1,1,1,1,1,1,
1,0,0,1,0,1,0,0,0,0,1,0,0,0,1,1,1,1,1,1,
1,0,0,1,0,1,0,0,0,8,1,0,0,0,1,1,1,0,0,0,
1,0,0,1,0,1,0,0,4,1,1,0,0,0,1,0,0,0,0,0,
1,0,0,1,0,1,0,0,0,0,0,0,0,0,1,0,0,0,1,0,
1,0,0,1,0,1,0,0,0,0,0,0,0,0,1,0,0,0,0,0,
1,0,0,0,0,1,4,4,4,4,4,4,4,4,1,7,0,1,0,0,
0,0,0,0,0,0,0,0,0,0,0,0,0,0,0,0,1,1,1,1,
0,0,0,0,0,0,0,0,0,0,0,0,0,0,0,0,6,6,1,1],
"playerDirection": 2,
"laserCadences":[],
"laserOffsets": [],
"mouseDelays":[5],
"starTargets":[172,164],
"movesPosition":[6,4]
}
