{"grid":[
9,0,0,0,0,1,1,0,0,0,1,0,0,0,0,0,0,0,0,1,
1,1,1,1,0,0,0,0,0,0,1,0,0,0,0,1,0,1,1,1,
1,1,1,1,1,0,0,0,0,0,1,0,0,1,1,1,0,0,6,1,
1,1,1,1,1,0,1,1,1,1,1,0,1,1,1,1,1,1,1,1,
1,1,1,1,1,0,1,1,1,1,1,0,1,1,1,1,1,1,1,1,
0,0,0,0,0,0,0,0,0,0,0,0,0,0,0,0,0,0,0,3,
0,1,1,1,1,1,1,1,1,1,1,1,1,1,1,0,1,1,1,1,
0,1,1,1,1,1,1,1,1,1,1,1,0,0,0,0,1,1,1,1,
0,1,1,1,0,0,0,0,0,0,1,1,0,1,1,1,1,1,1,1,
0,0,0,0,0,0,0,0,0,0,1,1,0,1,1,1,1,1,1,1,
1,1,1,1,0,0,0,0,0,0,0,0,0,0,0,0,0,0,0,3,
1,1,1,1,1,0,0,0,0,0,1,1,8,0,0,0,0,0,1,1],
"playerDirection": 2,
"laserOffsets": [1],
"starTargets":[113,101]
}
