{"grid":[
0,0,0,0,0,0,1,0,0,0,0,0,0,0,0,0,0,0,0,0,
0,1,1,5,1,0,1,0,0,0,0,0,0,0,0,0,0,0,0,0,
0,0,0,0,0,0,1,0,1,1,1,1,1,1,1,1,1,1,1,0,
0,1,1,0,1,0,1,0,1,1,1,1,1,1,1,1,1,1,1,0,
0,1,0,0,1,0,1,7,1,1,1,1,1,1,1,1,1,1,1,0,
7,1,6,0,1,0,1,0,0,0,0,0,0,0,0,0,0,0,0,0,
0,1,6,0,0,0,1,0,1,1,1,0,0,0,0,0,0,0,0,0,
0,1,9,1,1,1,1,0,0,0,0,0,0,0,0,0,0,0,0,0,
0,1,1,1,0,0,0,0,0,0,0,0,1,8,0,0,0,0,0,0,
0,0,0,0,0,0,1,0,0,0,0,0,1,1,0,0,0,0,0,0,
0,1,1,1,0,0,0,0,0,0,0,0,1,1,0,0,0,0,0,0,
4,1,1,1,1,1,1,1,1,1,1,1,1,1,1,1,1,1,1,4],
"playerDirection": -1,
"mouseDelays":[19,5],
"starTargets":[182,172],
"movesPosition":[2,11]
}
