{"grid":[
9,0,0,0,0,0,0,7,1,1,0,0,0,0,0,0,0,0,0,0,
0,0,0,0,0,0,0,0,6,1,0,0,1,1,0,0,2,0,0,1,
0,0,1,1,1,1,1,1,1,1,0,0,1,1,0,0,0,0,0,1,
0,0,1,1,1,1,1,1,1,1,0,0,1,1,0,0,0,0,0,1,
0,0,1,1,1,1,1,1,1,1,0,0,1,1,0,0,0,0,0,1,
0,0,0,0,0,0,0,0,0,0,0,0,0,0,0,0,0,0,0,3,
1,1,1,1,1,1,1,1,1,1,0,0,1,1,0,0,0,1,0,1,
1,1,1,1,1,1,1,1,1,1,0,0,1,1,0,0,0,1,0,1,
1,1,1,1,1,1,1,1,1,1,0,0,0,0,0,0,0,1,0,1,
1,1,1,1,1,1,1,1,1,1,0,0,0,0,0,0,1,1,0,1,
1,1,1,1,1,1,1,1,1,1,0,1,1,0,0,1,1,1,6,1,
1,1,1,1,1,1,1,1,1,1,8,1,1,1,1,1,1,1,1,1],
"playerDirection": 2,
"laserCadences":[3,100000],
"laserOffsets":[1],
"mouseDelays":[16],
"starTargets":[109,107],
"movesPosition":[6,10]
}
