{"grid":[
9,0,0,0,0,0,0,0,7,1,1,0,0,0,0,0,0,0,0,0,
0,0,0,0,0,0,0,0,0,6,1,0,0,1,1,0,0,0,0,1,
0,0,1,1,1,1,1,1,1,1,1,0,0,1,1,0,0,0,0,1,
0,0,1,1,1,1,1,1,1,1,1,0,0,1,1,0,0,0,0,1,
0,0,1,1,1,1,1,1,1,1,1,0,0,1,1,0,0,0,0,1,
0,0,0,0,0,0,0,0,0,0,0,0,0,0,0,0,0,0,0,3,
1,1,1,1,1,1,1,1,1,1,1,0,0,1,1,0,0,1,0,1,
1,1,1,1,1,1,1,1,1,1,1,0,0,1,1,0,0,1,0,1,
1,1,1,1,1,1,1,1,1,1,1,0,0,0,0,0,0,1,0,1,
1,1,1,1,1,1,1,1,1,1,1,0,0,0,0,0,0,1,0,1,
1,1,1,1,1,1,1,1,1,1,1,0,1,1,0,0,0,1,6,1,
1,1,1,1,1,1,1,1,1,1,1,8,1,1,0,0,1,1,1,1],
"playerDirection": 2,
"laserCadences":[100000],
"mouseDelays":[14],
"starTargets":[108,106],
"movesPosition":[12,8]
}
