{"grid":[
9,0,0,0,0,0,0,0,0,0,0,0,0,0,0,0,0,0,7,1,
0,0,0,0,0,0,0,0,0,0,0,0,0,0,0,0,0,0,6,1,
0,1,1,1,1,1,1,1,1,1,1,1,1,1,1,1,1,1,0,1,
0,0,0,0,0,0,1,0,0,0,0,0,0,0,1,1,1,1,0,1,
0,0,0,0,0,0,1,0,0,0,0,0,0,0,1,1,1,1,0,1,
1,1,1,1,1,0,0,0,0,0,0,0,0,0,1,1,1,1,0,1,
1,1,1,1,1,0,0,0,0,0,0,0,0,0,1,1,0,0,0,0,
1,1,1,1,1,0,0,1,1,1,1,1,1,0,1,1,0,0,0,0,
0,0,0,0,1,0,0,1,1,1,1,1,1,0,1,8,0,1,0,0,
0,0,0,0,0,0,0,0,0,0,0,0,0,0,0,0,0,1,1,10,
1,1,1,1,1,1,1,1,1,1,1,1,1,0,1,1,0,0,0,6,
1,1,1,1,1,1,1,1,1,1,1,1,1,4,1,1,1,1,1,1],
"playerDirection": 2,
"laserCadences":[13],
"laserOffsets": [3],
"mouseDelays":[3],
"starTargets":[159,149],
"movesPosition":[8,8]
}
