{"grid":[
1,1,1,1,1,1,1,1,1,9,0,0,0,0,0,0,0,0,0,0,
0,0,0,0,0,0,0,0,0,0,0,0,0,0,0,0,0,0,0,0,
0,0,0,0,0,0,0,0,0,0,0,0,0,0,0,0,0,0,0,0,
0,1,1,1,1,1,1,1,1,1,1,1,1,5,1,1,1,1,1,0,
0,1,1,1,1,7,0,0,0,0,2,0,0,0,0,0,0,0,0,0,
0,0,0,0,0,0,0,0,0,0,1,0,0,0,0,0,0,0,0,0,
0,0,0,0,0,0,0,0,0,0,1,0,0,0,0,0,0,0,0,0,
4,1,1,1,1,0,0,0,0,0,10,0,0,0,0,0,0,0,1,1,
0,0,0,0,0,0,1,1,1,1,1,1,1,1,1,0,0,0,0,0,
0,1,0,0,0,0,5,1,1,1,0,1,1,1,1,0,0,0,0,0,
0,2,0,0,0,0,0,0,0,0,0,0,0,0,0,0,0,0,0,0,
8,1,1,0,0,0,0,0,0,1,6,1,0,0,0,0,0,0,0,0],
"playerDirection": 1,
"laserCadences":[3,2,2,2,9],
"laserOffsets": [1,1,1,1,4],
"mouseDelays":[14],
"starTargets":[190,186],
"movesPosition":[19,8]
}
