{"grid":[
9,0,0,1,0,0,0,1,1,1,0,0,0,0,0,3,5,5,5,8,
1,1,0,1,0,1,0,0,0,0,0,0,0,0,0,0,0,0,0,0,
1,1,0,0,0,1,0,0,0,0,0,0,0,0,0,0,0,0,0,0,
1,1,0,0,1,1,0,0,0,0,0,0,0,0,0,0,1,1,1,1,
1,1,1,1,1,1,0,0,0,0,0,0,0,0,0,0,1,0,0,0,
1,1,1,1,1,10,0,0,0,0,0,0,0,0,0,0,0,0,0,0,
1,1,1,1,1,1,1,0,0,0,0,0,0,0,0,0,0,0,0,0,
1,1,1,1,1,0,0,0,0,0,0,0,0,0,0,0,0,0,0,1,
1,1,1,1,1,0,1,1,0,0,0,0,0,0,0,0,0,0,0,1,
1,1,1,1,1,0,1,1,0,0,0,0,0,1,1,1,1,0,0,1,
1,1,1,1,1,0,1,2,0,0,0,0,0,1,1,1,1,0,0,1,
1,1,1,1,1,0,0,0,0,0,0,0,0,0,0,0,0,0,0,0],
"playerDirection": 2,
"laserCadences":[],
"laserOffsets": [1,1,0,1,0],
"mouseDelays":[],
"starTargets":[201,75],
"movesPosition":[14,10]
}
