{"grid":[
1,1,1,1,1,1,1,9,0,0,1,1,1,1,1,1,1,1,1,1,
1,1,1,1,1,1,2,0,0,0,0,0,0,1,1,1,1,1,1,1,
1,1,1,1,1,1,2,0,0,0,0,0,0,1,1,1,1,1,1,1,
1,1,1,1,1,1,2,0,0,0,0,0,0,1,1,1,1,1,1,1,
1,1,1,1,1,1,1,0,0,0,0,0,0,1,1,1,1,1,1,1,
1,1,1,1,1,1,1,1,1,1,1,1,0,1,1,1,1,1,1,1,
1,1,1,1,1,1,1,0,0,0,0,0,0,3,1,1,1,1,1,1,
1,1,1,1,1,1,1,0,0,0,0,0,0,3,1,1,1,1,1,1,
1,1,1,1,1,1,1,0,0,0,0,0,0,3,1,1,1,1,1,1,
1,1,1,1,1,1,1,0,0,0,0,0,0,3,1,1,1,1,1,1,
1,1,1,1,1,1,1,0,0,0,0,0,0,3,1,1,1,1,1,1,
1,1,1,1,1,1,1,0,0,0,0,0,0,0,0,0,0,0,0,8
],
"playerDirection": 2,
"laserCadences":[2,3,4,2,3,4,5,6],
"laserOffsets": [0,0,0,0,1,0,3,4]
}