{"grid":[
9,0,0,0,0,0,0,1,1,1,1,1,1,1,1,1,1,1,1,8,
0,0,0,0,0,0,0,1,1,1,1,1,1,1,1,1,1,1,1,0,
0,1,1,1,1,1,0,1,1,1,1,1,1,1,1,1,1,1,1,0,
0,1,1,1,1,1,0,1,1,1,1,1,1,1,1,1,1,1,1,0,
0,1,1,1,1,1,0,1,1,1,1,1,1,1,1,1,1,1,1,0,
0,1,1,1,1,1,0,1,1,1,1,1,1,1,1,1,1,1,1,0,
0,1,1,1,1,1,0,1,1,1,1,1,1,1,1,1,1,1,1,0,
0,1,1,1,1,1,0,1,1,1,1,1,1,1,1,1,1,1,1,0,
0,0,0,0,6,1,0,1,1,1,1,1,1,1,1,1,1,1,1,0,
0,0,0,0,0,1,0,0,0,0,0,0,0,0,0,0,0,0,0,0,
0,0,0,0,0,1,0,0,0,0,0,0,0,0,0,0,0,0,0,0,
1,1,1,1,1,1,1,1,1,1,1,1,1,1,1,1,1,1,1,4],
"playerDirection": 2,
"laserCadences":[2,3,4,2,3,4,5,6],
"laserOffsets": [0,0,0,0,1,0,3,4],
"starTargets":[76,75,67]
}