{"grid":[
0,0,0,0,1,1,0,0,0,1,0,0,0,0,0,0,0,0,1,5,
0,0,0,6,1,0,0,0,0,1,0,0,0,0,0,0,0,0,1,0,
0,1,1,1,1,0,0,0,0,0,0,0,0,0,0,0,0,0,0,0,
0,0,0,0,0,0,0,0,0,0,0,0,0,0,0,0,0,0,0,0,
0,0,0,0,0,0,1,0,0,0,0,0,0,0,0,0,0,0,0,0,
9,0,0,0,0,0,0,0,1,0,0,0,0,0,0,0,0,0,0,0,
1,1,1,1,1,1,1,1,1,1,1,1,1,1,1,1,1,1,1,0,
1,1,1,1,1,1,1,1,1,1,1,1,1,1,1,1,1,1,1,0,
1,1,1,1,1,1,1,1,1,1,1,1,1,1,1,1,1,1,1,0,
1,1,1,1,1,1,1,1,1,1,1,1,1,1,1,1,1,1,1,0,
1,1,1,1,1,1,1,1,1,1,1,1,1,1,1,1,1,1,1,0,
8,0,0,0,0,0,0,0,0,0,0,0,0,0,0,0,0,0,0,0
],
"playerDirection": 2,
"starTargets":[79,78,76]
}