{"grid":[
0,0,0,0,1,1,0,0,0,0,0,0,0,0,0,0,0,0,1,5,
0,0,0,6,1,1,0,0,0,0,0,0,0,0,0,0,0,0,1,0,
0,1,1,1,1,0,0,0,0,0,0,0,0,0,0,0,0,0,0,0,
0,0,0,0,0,0,0,0,0,0,0,0,0,0,0,0,0,0,0,0,
0,0,0,0,0,0,1,0,0,0,0,0,0,0,0,0,0,0,0,0,
0,6,9,6,0,0,0,1,0,0,0,0,0,0,0,0,0,0,0,0,
1,1,1,1,1,1,1,1,1,1,1,1,1,1,1,1,1,1,1,0,
1,1,1,1,1,1,1,1,1,1,1,1,1,1,1,1,1,1,1,0,
1,1,1,1,1,1,1,1,1,1,1,1,1,1,1,1,1,1,1,0,
1,1,1,1,1,1,1,1,1,1,1,1,1,1,1,1,1,1,1,0,
1,1,1,1,1,1,1,1,1,1,1,1,1,1,1,1,1,1,1,0,
8,0,0,0,0,0,0,0,0,0,0,0,0,0,0,0,0,0,0,0
],
"playerDirection": "right",
"guardDirections": ["up"]
}