{"grid":[
1,1,1,1,1,1,1,1,1,1,1,1,1,1,1,1,1,1,1,1,
1,1,1,1,1,1,1,1,1,1,1,1,1,1,1,1,1,1,1,1,
1,1,1,1,1,1,1,1,1,1,1,1,1,1,1,1,1,1,1,1,
1,1,1,1,1,1,1,1,1,1,1,1,1,1,1,1,1,1,1,1,
1,1,1,1,1,1,1,1,1,1,1,1,1,1,1,1,1,1,1,1,
9,0,0,0,0,0,0,0,0,7,1,0,0,0,0,0,0,0,0,3,
0,0,0,0,0,0,0,0,0,0,1,0,0,0,0,0,0,0,8,1,
1,1,1,1,1,1,1,1,1,0,0,0,0,1,1,1,1,1,1,1,
1,1,1,1,1,1,1,6,1,0,0,0,0,1,1,1,1,1,1,1,
1,1,1,1,1,1,1,0,0,0,0,0,0,1,1,1,1,1,1,1,
1,1,1,1,1,1,1,1,1,1,1,1,1,1,1,1,1,1,1,1,
1,1,1,1,1,1,1,1,1,1,1,1,1,1,1,1,1,1,1,1],
"playerDirection": 2,
"mouseDelays": [3],
"starTargets":[47,46,45]
}
