{"grid":[
9,0,0,0,0,0,0,0,7,7,7,1,1,1,0,0,0,0,0,8,
1,1,1,1,1,1,1,1,1,1,0,1,1,2,0,0,0,0,0,0,
0,0,0,0,1,1,1,1,1,1,0,1,1,1,0,1,1,1,1,1,
0,1,1,0,1,1,1,1,1,1,0,1,1,1,0,1,1,1,1,1,
0,0,0,0,3,1,1,1,1,1,0,1,1,0,0,1,1,1,1,1,
0,1,1,0,1,1,1,1,1,1,0,1,1,0,1,1,1,1,1,1,
0,1,1,0,1,1,1,1,1,1,0,1,1,0,0,0,0,0,0,0,
0,0,1,0,1,1,1,1,1,1,0,1,1,0,1,1,1,1,1,0,
1,0,1,0,1,1,1,1,1,1,0,1,1,0,1,1,1,1,1,0,
0,0,1,0,1,1,1,1,1,1,0,1,1,0,1,1,1,1,1,0,
0,1,1,0,1,1,1,1,1,1,0,1,1,0,1,1,1,1,1,0,
0,0,0,0,0,0,0,0,0,0,0,0,0,0,0,0,0,0,0,0],
"playerDirection": 2,
"laserCadences":[7,5],
"laserOffsets": [1,0],
"mouseDelays":[23,24,2],
"starTargets":[117,115],
"movesPosition":[12,11]
}
