{"grid":[
    9,0,0,0,0,0,0,0,6,0,0,3,0,0,0,0,0,0,0,0,
    0,0,0,0,0,0,0,0,0,1,0,0,0,0,0,0,0,0,1,0,
    0,0,0,0,0,0,0,0,0,0,0,0,0,0,0,1,0,0,0,0,
    0,0,0,0,0,0,6,6,6,6,6,6,0,0,0,0,0,0,0,0,
    0,0,1,0,0,0,0,0,0,0,0,0,0,0,0,0,0,0,0,0,
    0,0,0,0,0,0,0,6,0,1,0,0,0,0,0,0,0,0,0,0,
    0,0,0,0,0,0,0,0,0,0,0,0,0,1,0,0,0,0,0,0,
    6,0,0,0,1,0,0,0,0,0,0,0,0,0,0,0,0,0,0,6,
    6,0,1,0,0,0,0,6,0,6,0,0,1,1,0,1,0,0,0,6,
    6,0,0,0,0,0,0,0,0,0,0,0,0,1,0,1,0,0,1,6,
    6,1,0,0,0,0,0,1,0,0,0,0,0,1,0,1,0,0,1,6,
    6,1,0,0,0,0,0,0,0,0,0,0,0,1,8,1,0,0,1,6],
    "playerDirection": 2,
    "laserCadences":[],
    "laserOffsets": [],
    "mouseDelays":[2, 3, 4]
    }
    