{"grid":[
9,0,1,1,0,0,0,0,0,0,0,0,0,0,0,0,0,0,0,0,
0,0,0,1,0,1,0,0,0,0,0,0,0,0,0,0,0,0,0,0,
0,0,0,1,0,1,0,0,0,0,0,0,0,0,0,0,0,0,0,0,
0,1,7,1,0,1,0,0,0,0,0,0,0,0,0,0,0,0,0,0,
0,1,0,1,0,1,0,0,0,0,0,0,0,0,0,0,0,0,0,0,
0,1,0,1,0,1,0,0,0,0,0,0,0,0,0,0,0,0,0,0,
7,0,0,0,0,0,0,0,0,0,0,0,0,0,0,0,0,0,0,0,
1,1,0,1,0,1,0,0,0,0,0,0,0,0,0,0,0,0,0,1,
1,1,0,1,0,1,0,0,0,0,0,0,0,0,0,0,0,0,0,0,
1,1,0,1,0,1,0,0,0,0,0,0,0,0,0,0,0,0,0,0,
1,1,0,1,0,1,0,0,0,0,0,0,0,0,0,0,0,0,0,0,
1,1,0,0,0,1,0,0,0,0,0,0,0,0,0,0,0,6,6,8],
"playerDirection": 2,
"mouseDelays":[15,4],
"starTargets":[153,152,150]
}
    