{"grid":[
9,7,0,0,0,0,0,0,0,0,0,0,0,0,0,0,0,0,0,0,
0,1,1,1,1,1,1,1,1,1,5,1,1,1,1,1,1,1,1,6,
0,1,0,0,0,0,0,0,0,0,0,0,0,0,0,0,0,1,1,0,
8,1,0,1,1,1,1,1,1,1,0,1,1,1,1,1,0,1,1,0,
1,1,0,0,0,0,0,0,0,0,0,0,0,0,0,0,0,1,1,0,
0,0,0,1,1,1,1,1,1,1,1,1,1,1,1,1,1,1,1,0,
0,1,0,1,1,1,1,1,1,1,1,1,1,1,1,1,1,1,1,0,
0,1,0,1,1,1,1,1,1,1,1,1,1,1,1,1,1,1,1,0,
0,1,0,1,1,1,1,1,1,1,1,1,1,1,1,1,1,1,1,0,
0,0,0,0,0,0,0,0,0,0,0,0,0,0,0,0,0,0,0,0,
1,1,1,1,1,1,1,1,1,1,1,1,1,1,1,1,1,1,1,0,
1,1,1,1,1,1,1,1,1,1,1,1,1,1,1,1,1,1,1,4],
"playerDirection": 2,
"laserCadences":[6,2],
"laserOffsets":[1,1],
"mouseDelays":[2],
"starTargets":[147,143],
"movesPosition":[11,9]
}
    